{
  "tileSize": 40,
  "width": 30,
  "height": 20,
  "legend": {
    ".": "sand — walkable open ground",
    "R": "rock — walkable rough terrain (slower / pathfinding prefers sand)",
    "B": "block — impassable obstacle (walls / cliffs)"
  },
  "rows": [
    "..............................",
    "..............................",
    "...RRRRR......................",
    "...R...R...........BBBB.......",
    "...R...R...........BBBB.......",
    "...RRRRR...........BBBB.......",
    ".............RRR...BBBB.......",
    ".............R.R..............",
    ".............RRR..............",
    "..............................",
    ".....BBBB.....................",
    ".....BBBB...........RRRR......",
    ".....BBBB...........R..R......",
    ".....BBBB...........RRRR......",
    "..............................",
    "...............BBBB...........",
    "...............BBBB...........",
    "...............BBBB...........",
    "...............BBBB...........",
    ".............................."
  ]
}
