{
  "tileSize": 40,
  "width": 48,
  "height": 48,
  "disableStaticObstacles": false,
  "legend": {
    ".": "sand - walkable open ground",
    "R": "rock - walkable rough terrain",
    "B": "block - impassable obstacle"
  },
  "goldMines": [
    { "x": 6, "y": 6, "amount": 5000 },
    { "x": 24, "y": 6, "amount": 7000 },
    { "x": 42, "y": 6, "amount": 5000 },
    { "x": 8, "y": 24, "amount": 7000 },
    { "x": 24, "y": 24, "amount": 10000 },
    { "x": 40, "y": 24, "amount": 7000 },
    { "x": 6, "y": 42, "amount": 5000 },
    { "x": 24, "y": 42, "amount": 7000 },
    { "x": 42, "y": 42, "amount": 5000 }
  ],
  "rows": [
    "................................................",
    "................................................",
    "................................................",
    "................................................",
    "....BBBB....BBBB....BBBB....BBBB....BBBB....BBBB",
    "................................................",
    "................................................",
    "................................................",
    "................................................",
    "................................................",
    "RRRRRRRRRRRR....RRRRRRRRRRRR....RRRRRRRRRRRR....",
    "................................................",
    "................................................",
    "................................................",
    "................................................",
    "....BBBB....BBBB....BBBB....BBBB....BBBB....BBBB",
    "................................................",
    "................................................",
    "................................................",
    "................................................",
    "................................................",
    "................................................",
    "RRRRRRRRRRRR....RRRRRRRRRRRR....RRRRRRRRRRRR....",
    "................................................",
    "................................................",
    "................................................",
    "................................................",
    "....BBBB....BBBB....BBBB....BBBB....BBBB....BBBB",
    "................................................",
    "................................................",
    "................................................",
    "................................................",
    "................................................",
    "RRRRRRRRRRRR....RRRRRRRRRRRR....RRRRRRRRRRRR....",
    "................................................",
    "................................................",
    "................................................",
    "................................................",
    "....BBBB....BBBB....BBBB....BBBB....BBBB....BBBB",
    "................................................",
    "................................................",
    "................................................",
    "................................................",
    "................................................",
    "RRRRRRRRRRRR....RRRRRRRRRRRR....RRRRRRRRRRRR....",
    "................................................",
    "................................................",
    "................................................"
  ]
}
