{
  "tileSize": 40,
  "width": 128,
  "height": 128,
  "disableStaticObstacles": true,
  "legend": {
    ".": "sand - walkable open ground",
    "R": "rock - walkable rough terrain (slower / pathfinding prefers sand)",
    "B": "block - impassable obstacle (walls / cliffs)"
  },
  "goldMines": [
    { "x": 18, "y": 18, "amount": 3200 },
    { "x": 64, "y": 18, "amount": 3600 },
    { "x": 108, "y": 20, "amount": 3200 },
    { "x": 24, "y": 64, "amount": 4200 },
    { "x": 64, "y": 64, "amount": 5000 },
    { "x": 104, "y": 64, "amount": 4200 },
    { "x": 18, "y": 110, "amount": 3200 },
    { "x": 64, "y": 110, "amount": 3600 },
    { "x": 108, "y": 108, "amount": 3200 }
  ],
  "rows": [
    "................................................................................................................................",
    "................................................................................................................................",
    "................................................................................................................................",
    "................................................................................................................................",
    "................................................................................................................................",
    "................................................................................................................................",
    "................................................................................................................................",
    "................................................................................................................................",
    "........BBBBBBBBBBBBBBBBBB................................................BBBBBBBBBBBBBBBBBBBB..................................",
    "........BB..B....B.......B................................................B.....B....B....BB.B..................................",
    "........B....BB..........B..............BBBBBBBBBBBBBBBBBBBBBB............B................B.B..................................",
    "........B....B...........B..............B.....B.......B.B..B.B............B.................BB..................................",
    "........B..B............BB...RR.........B.................................B.................BB..................................",
    "........B.BB............RBRRR.R.........B.................................B..................B..................................",
    "........BB..............BB..R.RR.R......B.................................B...............B..B....BBBBB.........BBBBBB..........",
    "........B................B..............B.................................B.............BB...B....BB............B....B..........",
    "........BB...............B..............B.................................B.............B....B....B..................B..........",
    "........BB...............B..............B.................................B.................BB....B..................B..........",
    "........B................B..............BB..............BB................B..................B....B.................BB..........",
    "........B................B..............B................B...B............B..................B....BB................BB..........",
    "........B...B...........BB..............B....................B............B..................B....B..................B..........",
    "........BBBBBBBBBBBBBBBBBB..............B....................B............BBBBBBBBBBBBBBBBBBBB....B..................B..........",
    "...............RR.......R.R.R.R.R.RRR.R.B....................B.......................RRRRR.R.R...RB.BB..R............B..........",
    "................R.......RRRR..RRR.R...R.B.................B..B......................RRRR.RR.R.RR.RBBBRR.R.......R....B..........",
    "................R.......RR..R.RRRRRRRR..B...B.......B.B.BBB..B.......................RRRRRR.R...RRBB..R.........R...BB..........",
    "..............RRR.......RRRRR.R..RRRR.R.BBBBBBBBBBBBBBBBBBBBBB..........................RRRR.RR..RB.R..RR........R...B..........",
    "................R.......R..R....R..R.RR............................................R.R..R.RRRRR.RRBR..RR.........RBB.B..........",
    "..............R.R.......RRRRRR.RRR..RRR............................................RRRRRR.R.R.R.RRBRR.R.R.......R..B.B..........",
    "..............R.R.......R..RR.RRRRRRRR..............................................R......RR...RRB.RRR.........RR...B..........",
    "........................R..RR.RRRR..R..............................................R..RRRR.RR..RRRB...BR........RR...B..........",
    "...............R........R..RRR.R..R.R..............................................R.RRR.RRRRRRRRRBRR.R.........RR...B..........",
    "........................RR.R.....RR.................................................RR....RR..R..RBBBBBBBBBBBBBBBBBBBB..........",
    "................R.......R.RR.RRRRRR.R................................................RR..RRR.R.RR................R..............",
    ".........................R..RR.R.....................................................R.RRR..R..RRR.R.RR..........R..............",
    "........................RRRRR.RRR..................................................R.R.RRRR.R..RR.RRRR.RR.......RR..............",
    ".........................RRRR.R.R...................................................RRR.R..RR.RRR.R.RRRRR.......R...............",
    "..........................RRRRR...........BBBBBBBBBBBBBBBBBBBBBBBB..................RRR.RR.R.RR..RRRRRR.........................",
    "..........................................B........B...........B.B..................RR.R.R....R.R..RR.RRR.......R...............",
    "..........................................B......................B...................RRR..RRRRR.R.RRR.RRR.......................",
    "..........................................B......................B...................RRRRRR.RR.R..R.RR..R.......................",
    "............BBBBBBBBBBBBBBBBBB............B......................B....................R..R.RRRRRRRRRRR.R........................",
    "............B....B.B.....B...B............B........B.............B.......................R.R..R.R....RRRR.......................",
    "............B................B............B........BB............B..........BBBBBBBBBBBBBBBBBBRRR..R..RRR.......................",
    "............B......B.........B............B......................B..........B.B...B.......RRRBRRRRRRRR..R.......................",
    "............B.....BB.........B............B.....................BB..........B.....B..........B.RRRR.BBBBBBBBBBBBBBBBBB..........",
    "............B......B.........B............B......................B..........B....B...........B.....RBRRB......B..B...B..........",
    "............B.............BB.B............B.....BB...............B..........B...BB...........B......B................B..........",
    "............B..............B.B............B.....B................B..........B................B......BB...............B..........",
    "............B................B............B.....B...............BB..........B................B......B................B..........",
    "............B................B............BB....BB...............B..........B................B......B................B..........",
    "............B................B............B....B.............BB..B..........BB.......B.......B......B................B..........",
    "............B................B............BBBBBBBBBBBBBBBBBBBBBBBB..........B.......BB.......B......B................B..........",
    "............BB.BB............B..............................................B......B.B.......B......B................B..........",
    "............B..B.............B..............................................B....BB.B........B......B........B.......B..........",
    "............B..BB............B..............................................B.....B.........BB......B...............BB..........",
    "............BBB..............B..............................................B.....BB.........B......B...............BB..........",
    "............B..BB...........BB..............................................B....B.B.........B......B...............BB..........",
    "............B..B.............B..............................................BB...............B......B................B..........",
    "............B...BB......B....B..............................................BB...............B......B................B..........",
    "............BBBBBBBBBBBBBBBBBB..............................................B...............BB......B................B..........",
    "............................................................................B..B..B......B...B......B...B............B..........",
    "............................................................................BBBBBBBBBBBBBBBBBB......BBBBB.........BBBB..........",
    "................................................................................................................................",
    "................................................................................................................................",
    "................................................................................................................................",
    "................................................................................................................................",
    "................................................................................................................................",
    "................................................................................................................................",
    "................................................................................................................................",
    "................................................................................................................................",
    "................................................................................................................................",
    "................................................................................................................................",
    "................................................................................................................................",
    "................................................................................................................................",
    "........................................BBBBBBBBBBBBBBBBBB............BBBBBBBBBBBBBBBBBBBBBBBB..................................",
    "........................................B.......B....B..BB............B..B.....B.........B...B..................................",
    "..........BBBBBBBBBBBBBBBBBBBB..........B........B..BB..BB............B........B.............B..................................",
    "..........B..................B..........B........BB.B....B............B.....................BB..................................",
    "..........B..................B..........B................B............B......................B..................................",
    "..........B..............RR.RBRR.R......B................B............B.........RR.RR....R...B..................................",
    "..........B........B....R.RRRBRRR.R.R...B..B.............B............B......RRR....RR..RR..RB......BBBBBBBBBBBBBBBB............",
    "..........B........BB.B..RR.BBRRRRR.RR..BBBB............BB............B.......RR..R.R.RR.R.RRB......B.........B....B............",
    "..........B..........BB..RR.RBRRRRRRR.R.B.B..............B............B...RR.RRR..RR.R.....RRBR.....B.............BB............",
    "..........B.............R.RRRBR.R.RR.RR.B.......B........B............B.R.R...R.RR.R..R..RRR.BRR....BB.............B............",
    "..........B.............R..RBB...RR.RR.RBB.....BB........B............BR..R.RRR.RR..R.R.R.R.RB.R.R..B..........B...B............",
    "..........BB............R....B.RRRR.RRR.BRR..............B............B..R..R....R...R.R.RRRBB.R....BB.BBB.....BB..B............",
    "..........B.............R..R.BR.R.RR.R..B.R.............BB............BR.R..R.RRRRR.....RR.RRBRRRRR.BBB.B..........B............",
    "..........B........BBB..RRRRRBR.RRRR..RRBR.....B..B....B.B............BR.RRRR.R..R.R.R...RRRRBRRRRRRB..............B............",
    "..........B..........B.....R.BR...RR...RBRR...BB.BB.....BB............B.R.RR.R.R....RR.R.RRR.BR....RB..............B............",
    "..........B..............R...BR.R....RR.BRRBB...B.B......B...........RBBRRR..R.RRBB.RR.R..RR.B..RRR.B....B.........B............",
    "..........BB............R....BRR.R.RR..RBRRB.............B...........RBBR.B...RR.RBRRRRB.RBR.BRRRRR.B..............B............",
    "..........B...............R.RBR.RR..RR.RBRRR.BB..........B...........RBBBBBBBBBBBBBBBBBBBBBBBB.RR...BR.............B............",
    "..........B....B.B...B..RBRRRB.RRRR.RR.RBB...B...........B...........R..RRRRR.R.RRR.RRR..RR.RRR.RRR.B..............B............",
    "..........BBBBBBBBBBBBBBBBBBBB.R...R.RRRB................B...........RR.R.R..RR.R.R..R.RRRR.R.RRRRRRB....B.........B............",
    "........................RR.RRRRR.R..R...BR.R........B....B............R.RR....R.R.RRRR.RRRRRRRR.R...BR...BB........B............",
    "........................RRR.R.....RRRRRRBBBBBBBBBBBBBBBBBB...........RRR..RRR..RR.R.R..RRRR.R.R.R..RBR.............B............",
    "........................RR.RR.R..RR..RR...RR.........................RRRRRRRRRRRRRRRR...RRRRRRRRRRRRB..............B............",
    ".........................RR...RR.RR..R.RRRR..........................RRR.R.R.RR...RR.R...R.RRR..R.R.B..............B............",
    "..........................R..RRRRRRRRR.RRRR...........................R.RRRRRRR.RR.R...R.RRRR.RRR.RRBB........B..B.B............",
    "........................RR.RRRR.R.RRRR.R..R..........................RRRR.RRRRR....RRRRRRRRR..RR.R.RBBBBBBBBBBBBBBBB............",
    "........................R..RRR..R.R.R.R..R...........................R.R..R.RR..RRRRRRRRR.RR...R.....R..........................",
    "..........................RRRRR..RRR.R.RR.............................R.RRRRRRR.RRRRR.RR.RR.RR.R.R.R.R..........................",
    ".........................RRR.R..RRRR.R..............BBBBBBBBBBBBBBBBBBBBR.RR.R..R.RRR.R..RR..RR.RR.RR...........................",
    "........................RRR....RRR.RR...............B......BB........BRBR...R.RR....RRRRR.R.RR.RRRRRR...........................",
    "..................BBBBBBBBBBBBBBBBBBBBBB............B..............BBBBBR..R.R..RR.RBBBBBBBBBBBBBBBBBBBB........................",
    "..................B.......RRR.RBRR.....B............B..............B.R.BRRR.RRRR.R..BRRR.RRRRRR.RBR.B..B........................",
    ".......................................B............BB...............BBB.RRRRR...R..BRRBBR..R....RB....B........................",
    ".......................................B............B................B.B............BB..B........BB....B........................",
    ".......................................B............B..................B............BBB...........B....B........................",
    "................................BB.....B............B..................B............B....B.............B........................",
    ".................................BB....B............B..................B............B...BB.............B........................",
    ".......................................B............B..................B............B..................B........................",
    ".......................................B............B.BB..............BB............B..................B........................",
    ".......................................B............B.B....B...........B............B..................B........................",
    ".......................................B............B...B.BB...........B............B..................B........................",
    ".......................................B............B...BBBB...........B............B.......BB.........B........................",
    "..................B....................B............B...B..............B............B.......BB.........B........................",
    "..................B....................B............B..................B............B......BB..........B........................",
    "..................B.B.......B.......BB.B............B.....B..........B.B............B...B..............B........................",
    "..................BBBBBBBBBBBBBBBBBBBBBB............BBBBBBBBBBBBBBBBBBBB............BBBBBBBBBBBBBBBBBBBB........................",
    "................................................................................................................................",
    "................................................................................................................................",
    "................................................................................................................................",
    "................................................................................................................................",
    "................................................................................................................................",
    "................................................................................................................................",
    "................................................................................................................................",
    "................................................................................................................................"
  ]
}
